"filename", "language", "C++", "C", "Ini", "comment", "blank", "total"
"d:\封片机\Glass_Package\glass_package_project\USER\Globalconfig.c", "C", 0, 94, 0, 33, 19, 146
"d:\封片机\Glass_Package\glass_package_project\USER\Globalconfig.h", "C++", 240, 0, 0, 17, 66, 323
"d:\封片机\Glass_Package\glass_package_project\USER\JLinkSettings.ini", "Ini", 0, 0, 35, 0, 1, 36
"d:\封片机\Glass_Package\glass_package_project\USER\codeGuard.c", "C", 0, 79, 0, 25, 10, 114
"d:\封片机\Glass_Package\glass_package_project\USER\codeGuard.h", "C++", 10, 0, 0, 3, 7, 20
"d:\封片机\Glass_Package\glass_package_project\USER\glassclaw_task.c", "C", 0, 699, 0, 53, 32, 784
"d:\封片机\Glass_Package\glass_package_project\USER\glassenter_task.c", "C", 0, 428, 0, 28, 27, 483
"d:\封片机\Glass_Package\glass_package_project\USER\glassout_task.c", "C", 0, 792, 0, 48, 30, 870
"d:\封片机\Glass_Package\glass_package_project\USER\glasspackage_task.c", "C", 0, 896, 0, 63, 42, 1001
"d:\封片机\Glass_Package\glass_package_project\USER\main.c", "C", 0, 164, 0, 63, 36, 263
"d:\封片机\Glass_Package\glass_package_project\USER\stm32f10x.h", "C++", 6168, 0, 0, 981, 1188, 8337
"d:\封片机\Glass_Package\glass_package_project\USER\stm32f10x_conf.h", "C++", 32, 0, 0, 38, 8, 78
"d:\封片机\Glass_Package\glass_package_project\USER\stm32f10x_it.c", "C", 0, 34, 0, 33, 16, 83
"d:\封片机\Glass_Package\glass_package_project\USER\stm32f10x_it.h", "C++", 13, 0, 0, 27, 7, 47
"d:\封片机\Glass_Package\glass_package_project\USER\system_stm32f10x.c", "C", 0, 525, 0, 401, 169, 1095
"d:\封片机\Glass_Package\glass_package_project\USER\system_stm32f10x.h", "C++", 12, 0, 0, 66, 21, 99
"Total", "-", 6475, 3711, 35, 1879, 1679, 13779